....................
....................
...........QQQQQ....
...............Q.X..
.................EEE
.........W.......EEE
.....QQQ.WW......EEE
..........W......E..
..........WWW...EE..
...WWW..........E...
.1.............EE...
.....Z........EE....
QQQ.......L..EE.....
QQQQ.........E......
QQQQQQQQQQQQQE......
