....................
....................
....................
.###................
....................
....................
.......G...X........
.......~~~~~........
.....G~.............
1..G.~..............
~~~~~~..............
....................
....................
....................
....................
